id,Name,visitor,visitor_percent,resident,resident_percent,net,net_point,net_percent
1,1,16615,0.006545704,10789,0.002749841,5826,0.003795863,0.3795863
2,2,11042,0.004350145,4126,0.001051612,6916,0.003298533,0.3298533
3,3,4583,0.001805535,3659,0.000932586,924,0.000872949,0.0872949
4,4,12556,0.004946606,4984,0.001270294,7572,0.003676312,0.3676312
5,5,10098,0.003978244,6546,0.001668408,3552,0.002309835,0.2309835
6,6,24532,0.009664713,19359,0.004934115,5173,0.004730598,0.4730598
7,7,7933,0.003125313,9229,0.002352237,-1296,0.000773076,0.0773076
8,8,9411,0.003707591,4643,0.001183382,4768,0.002524209,0.2524209
9,9,10020,0.003947515,11656,0.002970817,-1636,0.000976698,0.0976698
10,10,5334,0.002101401,5243,0.001336307,91,0.000765095,0.0765095
11,11,23354,0.009200624,18761,0.0047817,4593,0.004418924,0.4418924
12,12,24599,0.009691109,20804,0.005302409,3795,0.0043887,0.43887
13,13,13447,0.005297628,9665,0.002463362,3782,0.002834266,0.2834266
14,14,10102,0.00397982,8855,0.002256913,1247,0.001722906,0.1722906
15,15,12212,0.004811083,9425,0.002402192,2787,0.002408891,0.2408891
16,16,30274,0.011926852,26555,0.006768192,3719,0.00515866,0.515866
17,17,24382,0.009605619,14050,0.003580986,10332,0.006024633,0.6024633
18,18,14361,0.00565771,17217,0.004388174,-2856,0.001269536,0.1269536
19,19,2857,0.001125554,3552,0.000905314,-695,0.00022024,0.022024
20,20,13048,0.005140436,15663,0.003992099,-2615,0.001148337,0.1148337
21,21,4619,0.001819718,6086,0.001551166,-1467,0.000268552,0.0268552
22,22,6646,0.002618282,5777,0.00147241,869,0.001145872,0.1145872
23,23,5725,0.002255441,8146,0.002076207,-2421,0.000179234,0.0179234
24,24,11111,0.004377329,17290,0.00440678,-6179,-2.95E-05,-0.00294508
25,25,4935,0.00194421,9251,0.002357844,-4316,-0.000413634,-0.0413634
26,26,8678,0.003418816,11263,0.002870651,-2585,0.000548164,0.0548164
27,27,1415,0.000557458,1227,0.000312731,188,0.000244727,0.0244727
28,28,253,9.97E-05,632,0.000161081,-379,-6.14E-05,-0.00614079
29,29,10109,0.003982577,14138,0.003603415,-4029,0.000379162,0.0379162
30,30,3146,0.001239409,2947,0.000751115,199,0.000488294,0.0488294
31,31,1352,0.000532639,979,0.000249522,373,0.000283117,0.0283117
32,32,4276,0.001684588,5024,0.001280489,-748,0.000404099,0.0404099
33,33,10673,0.004204773,12983,0.003309035,-2310,0.000895737,0.0895737
34,34,15100,0.005948849,23147,0.005899579,-8047,4.93E-05,0.00492699
35,35,3146,0.001239409,3045,0.000776093,101,0.000463317,0.0463317
36,36,5648,0.002225106,7810,0.00199057,-2162,0.000234536,0.0234536
37,37,7849,0.00309222,11546,0.002942781,-3697,0.000149439,0.0149439
38,38,3414,0.001344992,3542,0.000902765,-128,0.000442226,0.0442226
39,39,6760,0.002663193,4092,0.001042946,2668,0.001620247,0.1620247
40,40,30134,0.011871697,17624,0.004491908,12510,0.007379789,0.7379789
41,41,6442,0.002537913,5476,0.001395693,966,0.00114222,0.114222
42,42,5048,0.001988728,3457,0.000881101,1591,0.001107627,0.1107627
43,43,12717,0.005010034,17182,0.004379253,-4465,0.000630781,0.0630781
44,44,5332,0.002100614,9049,0.002306359,-3717,-0.000205746,-0.0205746
45,45,6980,0.002749865,11230,0.00286224,-4250,-0.000112375,-0.0112375
46,46,9890,0.003896299,11012,0.002806678,-1122,0.001089622,0.1089622
47,47,19964,0.007865088,17361,0.004424876,2603,0.003440212,0.3440212
48,48,4999,0.001969424,7281,0.001855741,-2282,0.000113683,0.0113683
49,49,10950,0.004313901,5844,0.001489486,5106,0.002824414,0.2824414
50,50,9546,0.003760776,7910,0.002016057,1636,0.001744719,0.1744719
51,51,267,0.000105188,275,7.01E-05,-8,3.51E-05,0.00350978
52,52,3893,0.0015337,4440,0.001131643,-547,0.000402057,0.0402057
53,53,9720,0.003829326,14809,0.003774436,-5089,5.49E-05,0.00548895
54,54,16123,0.006351874,10044,0.002559959,6079,0.003791915,0.3791915
55,55,15756,0.006207289,13247,0.003376322,2509,0.002830967,0.2830967
56,56,1609,0.000633887,2610,0.000665222,-1001,-3.13E-05,-0.00313351
57,57,177,6.97E-05,628,0.000160061,-451,-9.03E-05,-0.00903296
58,58,4002,0.001576642,1655,0.000421817,2347,0.001154825,0.1154825
59,59,6478,0.002552096,10718,0.002731745,-4240,-0.000179649,-0.0179649
60,60,7393,0.002912572,8864,0.002259207,-1471,0.000653365,0.0653365
61,61,6866,0.002704954,10212,0.002602778,-3346,0.000102175,0.0102175
62,62,10869,0.00428199,15448,0.003937301,-4579,0.000344689,0.0344689
63,63,16759,0.006602435,21702,0.005531286,-4943,0.001071149,0.1071149
64,64,3616,0.001424572,5028,0.001281509,-1412,0.000143063,0.0143063
65,65,25051,0.00986918,19396,0.004943545,5655,0.004925635,0.4925635
66,66,4206,0.001657011,6261,0.001595769,-2055,6.12E-05,0.00612415
67,67,16352,0.006442092,12656,0.003225691,3696,0.0032164,0.32164
68,68,1633,0.000643342,1119,0.000285205,514,0.000358138,0.0358138
69,69,5423,0.002136464,8694,0.002215879,-3271,-7.94E-05,-0.00794144
70,70,13698,0.005396512,18367,0.004681279,-4669,0.000715233,0.0715233
71,71,6416,0.00252767,9675,0.002465911,-3259,6.18E-05,0.00617595
72,72,5342,0.002104553,5035,0.001283293,307,0.00082126,0.082126
73,73,9227,0.003635102,11253,0.002868102,-2026,0.000766999,0.0766999
74,74,9150,0.003604766,6987,0.001780808,2163,0.001823958,0.1823958
75,75,13887,0.005470972,12065,0.003075061,1822,0.002395911,0.2395911
76,76,5413,0.002132525,5850,0.001491016,-437,0.000641509,0.0641509
77,77,18408,0.007252081,13731,0.003499681,4677,0.003752399,0.3752399
78,78,10510,0.004140557,10310,0.002627756,200,0.001512801,0.1512801
79,79,19077,0.007515642,16092,0.00410144,2985,0.003414202,0.3414202
80,80,2463,0.000970332,5619,0.00143214,-3156,-0.000461807,-0.0461807
81,81,6950,0.002738047,9826,0.002504397,-2876,0.00023365,0.023365
82,82,4871,0.001918996,8322,0.002121065,-3451,-0.000202069,-0.0202069
83,83,15357,0.006050098,25140,0.006407544,-9783,-0.000357446,-0.0357446
84,84,7671,0.003022094,11026,0.002810246,-3355,0.000211848,0.0211848
85,85,14760,0.005814902,9359,0.00238537,5401,0.003429532,0.3429532
86,86,15098,0.005948061,19065,0.004859182,-3967,0.00108888,0.108888
87,87,8977,0.003536611,8334,0.002124124,643,0.001412487,0.1412487
88,88,20835,0.00820823,10439,0.002660635,10396,0.005547596,0.5547596
89,89,1215,0.000478666,1857,0.000473302,-642,5.36E-06,0.000536379
90,90,3683,0.001450968,7206,0.001836625,-3523,-0.000385658,-0.0385658
91,91,5582,0.002199104,9868,0.002515101,-4286,-0.000315997,-0.0315997
92,92,5137,0.002023791,7075,0.001803237,-1938,0.000220554,0.0220554
93,93,14686,0.005785748,14862,0.003787944,-176,0.001997804,0.1997804
94,94,15556,0.006128497,26837,0.006840066,-11281,-0.00071157,-0.071157
95,95,20068,0.00790606,15271,0.003892188,4797,0.004013872,0.4013872
96,96,6743,0.002656496,7577,0.001931184,-834,0.000725312,0.0725312
97,97,8488,0.003343962,15299,0.003899325,-6811,-0.000555362,-0.0555362
98,98,8574,0.003377843,14052,0.003581496,-5478,-0.000203653,-0.0203653
99,99,6396,0.002519791,10292,0.002623168,-3896,-0.000103377,-0.0103377
100,100,8212,0.003235229,13708,0.003493819,-5496,-0.000258591,-0.0258591
101,101,5431,0.002139616,9446,0.002407544,-4015,-0.000267928,-0.0267928
102,102,676,0.000266319,1160,0.000295654,-484,-2.93E-05,-0.0029335
103,103,9948,0.003919149,12860,0.003277686,-2912,0.000641463,0.0641463
104,104,5076,0.001999759,10767,0.002744233,-5691,-0.000744475,-0.0744475
105,105,5457,0.002149859,11444,0.002916783,-5987,-0.000766924,-0.0766924
106,106,8795,0.003464909,14070,0.003586084,-5275,-0.000121175,-0.0121175
107,107,7763,0.003058339,17005,0.00433414,-9242,-0.001275802,-0.1275802
108,108,8695,0.003425513,19896,0.005070983,-11201,-0.00164547,-0.164547
109,109,1882,0.000741439,3002,0.000765133,-1120,-2.37E-05,-0.00236938
110,110,19231,0.007576313,26430,0.006736332,-7199,0.00083998,0.083998
111,111,6540,0.002576522,11837,0.003016949,-5297,-0.000440428,-0.0440428
112,112,8191,0.003226955,15541,0.003961004,-7350,-0.000734049,-0.0734049
113,113,1056,0.000416025,1015,0.000258698,41,0.000157328,0.0157328
114,114,10557,0.004159073,19116,0.00487218,-8559,-0.000713107,-0.0713107
115,115,19901,0.007840268,7346,0.001872308,12555,0.00596796,0.596796
116,116,6817,0.002685649,10105,0.002575507,-3288,0.000110143,0.0110143
117,117,36490,0.014375729,12764,0.003253218,23726,0.011122512,1.1122512
118,118,16536,0.006514581,19521,0.004975405,-2985,0.001539176,0.1539176
119,119,170,6.70E-05,725,0.000184784,-555,-0.00011781,-0.011781
120,120,4278,0.001685376,6175,0.00157385,-1897,0.000111526,0.0111526
121,121,6936,0.002732531,9964,0.002539569,-3028,0.000192962,0.0192962
122,122,31519,0.012417337,21487,0.005476488,10032,0.006940849,0.6940849
123,123,6723,0.002648617,7312,0.001863642,-589,0.000784975,0.0784975
124,124,7438,0.002930301,9670,0.002464636,-2232,0.000465665,0.0465665
125,125,4569,0.001800019,10576,0.002695552,-6007,-0.000895533,-0.0895533
126,126,11620,0.004577856,16067,0.004095068,-4447,0.000482788,0.0482788
127,127,4303,0.001695225,5917,0.001508092,-1614,0.000187133,0.0187133
128,128,1495,0.000588975,4676,0.001191793,-3181,-0.000602818,-0.0602818
129,129,9031,0.003557885,16037,0.004087422,-7006,-0.000529537,-0.0529537
130,130,12028,0.004738593,20566,0.005241748,-8538,-0.000503155,-0.0503155
131,131,6717,0.002646253,11883,0.003028673,-5166,-0.00038242,-0.038242
132,132,15190,0.005984306,22074,0.005626099,-6884,0.000358207,0.0358207
133,133,5293,0.002085249,8689,0.002214604,-3396,-0.000129355,-0.0129355
134,134,19501,0.007682683,23096,0.005886581,-3595,0.001796102,0.1796102
135,135,7382,0.002908239,13557,0.003455333,-6175,-0.000547094,-0.0547094
136,136,1276,0.000502697,2338,0.000595897,-1062,-9.32E-05,-0.00931991
137,137,2222,0.000875387,1614,0.000411367,608,0.00046402,0.046402
138,138,735,0.000289563,399,0.000101695,336,0.000187868,0.0187868
139,139,5601,0.00220659,5488,0.001398751,113,0.000807839,0.0807839
140,140,13607,0.005360662,17345,0.004420798,-3738,0.000939864,0.0939864
141,141,2916,0.001148798,8779,0.002237543,-5863,-0.001088745,-0.1088745
142,142,4170,0.001642828,6542,0.001667389,-2372,-2.46E-05,-0.00245609
143,143,9048,0.003564582,17874,0.004555626,-8826,-0.000991044,-0.0991044
144,144,3211,0.001265017,6963,0.001774691,-3752,-0.000509674,-0.0509674
145,145,2301,0.00090651,7141,0.001820059,-4840,-0.000913549,-0.0913549
146,146,7109,0.002800687,12574,0.003204792,-5465,-0.000404105,-0.0404105
147,147,6453,0.002542247,9927,0.002530139,-3474,1.21E-05,0.00121078
148,148,2595,0.001022335,6076,0.001548617,-3481,-0.000526282,-0.0526282
149,149,4207,0.001657405,10629,0.002709061,-6422,-0.001051656,-0.1051656
150,150,3845,0.00151479,8369,0.002133044,-4524,-0.000618255,-0.0618255
151,151,2358,0.000928966,6178,0.001574615,-3820,-0.000645648,-0.0645648
152,152,7532,0.002967333,13766,0.003508602,-6234,-0.000541269,-0.0541269
153,153,5512,0.002171527,7964,0.00202982,-2452,0.000141707,0.0141707
154,154,9273,0.003653224,10153,0.002587741,-880,0.001065483,0.1065483
155,155,4280,0.001686164,12061,0.003074041,-7781,-0.001387877,-0.1387877
156,156,6709,0.002643101,12040,0.003068689,-5331,-0.000425587,-0.0425587
157,157,2948,0.001161404,6707,0.001709443,-3759,-0.000548039,-0.0548039
158,158,3082,0.001214196,4086,0.001041417,-1004,0.000172779,0.0172779
159,159,5302,0.002088795,5854,0.001492035,-552,0.000596759,0.0596759
160,160,6312,0.002486698,12852,0.003275647,-6540,-0.000788949,-0.0788949
161,161,8555,0.003370358,17772,0.004529629,-9217,-0.001159271,-0.1159271
162,162,5070,0.001997395,8686,0.00221384,-3616,-0.000216445,-0.0216445
163,163,6856,0.002701014,14499,0.003695425,-7643,-0.000994411,-0.0994411
164,164,9039,0.003561036,15828,0.004034153,-6789,-0.000473117,-0.0473117
165,165,5406,0.002129767,10971,0.002796228,-5565,-0.000666461,-0.0666461
166,166,5748,0.002264502,11574,0.002949917,-5826,-0.000685415,-0.0685415
167,167,2354,0.00092739,7618,0.001941634,-5264,-0.001014244,-0.1014244
168,168,6290,0.002478031,14371,0.003662801,-8081,-0.00118477,-0.118477
169,169,7711,0.003037853,15438,0.003934752,-7727,-0.000896899,-0.0896899
170,170,4924,0.001939876,7981,0.002034153,-3057,-9.43E-05,-0.00942767
171,171,8411,0.003313627,16931,0.00431528,-8520,-0.001001652,-0.1001652
172,172,5541,0.002182952,8966,0.002285205,-3425,-0.000102253,-0.0102253
173,173,3688,0.001452938,6430,0.001638843,-2742,-0.000185905,-0.0185905
174,174,7515,0.002960636,12864,0.003278705,-5349,-0.000318069,-0.0318069
175,175,13890,0.005472153,24578,0.006264305,-10688,-0.000792151,-0.0792151
176,176,7324,0.002885389,14080,0.003588633,-6756,-0.000703244,-0.0703244
177,177,3732,0.001470272,9126,0.002325984,-5394,-0.000855713,-0.0855713
178,178,7131,0.002809354,9899,0.002523002,-2768,0.000286352,0.0286352
179,179,5240,0.002064369,10301,0.002625462,-5061,-0.000561093,-0.0561093
180,180,355,0.000139857,479,0.000122085,-124,1.78E-05,0.00177722
181,181,7946,0.003130434,12382,0.003155856,-4436,-2.54E-05,-0.00254215
182,182,4206,0.001657011,8420,0.002146043,-4214,-0.000489032,-0.0489032
183,183,3349,0.001319384,10985,0.002799796,-7636,-0.001480412,-0.1480412
184,184,1794,0.000706771,5293,0.001349051,-3499,-0.00064228,-0.064228
185,185,1360,0.00053579,3397,0.000865809,-2037,-0.000330018,-0.0330018
186,186,3803,0.001498243,7891,0.002011214,-4088,-0.000512971,-0.0512971
187,187,3607,0.001421026,7298,0.001860074,-3691,-0.000439047,-0.0439047
188,188,7744,0.003050854,17830,0.004544412,-10086,-0.001493558,-0.1493558
189,189,3346,0.001318202,7961,0.002029056,-4615,-0.000710854,-0.0710854
190,190,408,0.000160737,1216,0.000309927,-808,-0.00014919,-0.014919
191,191,7589,0.002989789,13383,0.003410985,-5794,-0.000421196,-0.0421196
192,192,1650,0.00065004,2327,0.000593093,-677,5.69E-05,0.00569469
193,193,1329,0.000523578,1994,0.00050822,-665,1.54E-05,0.00153578
194,194,6133,0.002416178,12332,0.003143112,-6199,-0.000726934,-0.0726934
195,195,3978,0.001567187,8816,0.002246973,-4838,-0.000679786,-0.0679786
196,196,661,0.00026041,1993,0.000507965,-1332,-0.000247555,-0.0247555
197,197,3648,0.001437179,11424,0.002911686,-7776,-0.001474507,-0.1474507
198,198,2155,0.000848991,5428,0.001383459,-3273,-0.000534467,-0.0534467
199,199,737,0.000290351,1315,0.00033516,-578,-4.48E-05,-0.00448088
200,200,435,0.000171374,710,0.000180961,-275,-9.59E-06,-0.000958674
201,201,1768,0.000696528,4845,0.001234867,-3077,-0.000538339,-0.0538339
202,202,2038,0.000802898,4856,0.00123767,-2818,-0.000434773,-0.0434773
203,203,3495,0.001376903,6365,0.001622276,-2870,-0.000245373,-0.0245373
204,204,3743,0.001474606,9532,0.002429463,-5789,-0.000954858,-0.0954858
205,205,2476,0.000975454,6654,0.001695935,-4178,-0.000720481,-0.0720481
206,206,3050,0.001201589,6782,0.001728559,-3732,-0.00052697,-0.052697
207,207,17043,0.00671432,5189,0.001322544,11854,0.005391777,0.5391777
208,208,5558,0.002189649,11729,0.002989423,-6171,-0.000799773,-0.0799773
209,209,4679,0.001843355,9354,0.002384096,-4675,-0.00054074,-0.054074
210,210,1727,0.000680375,3501,0.000892316,-1774,-0.000211941,-0.0211941
211,211,5115,0.002015123,9575,0.002440423,-4460,-0.0004253,-0.04253
212,212,2950,0.001162192,3884,0.000989932,-934,0.00017226,0.017226
213,213,1101,0.000433754,2621,0.000668026,-1520,-0.000234272,-0.0234272
214,214,1987,0.000782806,4295,0.001094686,-2308,-0.00031188,-0.031188
215,215,1676,0.000660283,4042,0.001030203,-2366,-0.00036992,-0.036992
216,216,953,0.000375447,2201,0.000560979,-1248,-0.000185531,-0.0185531
217,217,7587,0.002989001,15707,0.004003313,-8120,-0.001014312,-0.1014312
218,218,4594,0.001809868,8383,0.002136613,-3789,-0.000326744,-0.0326744
219,219,5539,0.002182164,8309,0.002117752,-2770,6.44E-05,0.0064412
220,220,3744,0.001474999,7559,0.001926596,-3815,-0.000451597,-0.0451597
221,221,5996,0.002362205,13198,0.003363833,-7202,-0.001001628,-0.1001628
222,222,2599,0.001023911,4596,0.001171403,-1997,-0.000147492,-0.0147492
223,223,5218,0.002055702,9655,0.002460813,-4437,-0.000405111,-0.0405111
224,224,2448,0.000964423,5583,0.001422964,-3135,-0.000458541,-0.0458541
225,225,5789,0.002280655,9513,0.002424621,-3724,-0.000143966,-0.0143966
226,226,2713,0.001068823,7820,0.001993118,-5107,-0.000924295,-0.0924295
227,227,2216,0.000873023,3683,0.000938703,-1467,-6.57E-05,-0.00656795
228,228,2621,0.001032578,8794,0.002241366,-6173,-0.001208788,-0.1208788
229,229,3162,0.001245713,6691,0.001705365,-3529,-0.000459652,-0.0459652
230,230,2386,0.000939997,8824,0.002249012,-6438,-0.001309015,-0.1309015
231,231,2347,0.000924632,7392,0.001884032,-5045,-0.0009594,-0.09594
232,232,1892,0.000745379,3932,0.001002166,-2040,-0.000256787,-0.0256787
233,233,2023,0.000796988,4940,0.00125908,-2917,-0.000462092,-0.0462092
234,234,2119,0.000834809,7861,0.002003568,-5742,-0.00116876,-0.116876
235,235,10384,0.004090917,18696,0.004765133,-8312,-0.000674216,-0.0674216
236,236,4522,0.001781503,11482,0.002926469,-6960,-0.001144966,-0.1144966
237,237,2543,0.001001849,8438,0.002150631,-5895,-0.001148782,-0.1148782
238,238,4632,0.001824839,9455,0.002409838,-4823,-0.000584999,-0.0584999
239,239,7318,0.002883025,13073,0.003331974,-5755,-0.000448949,-0.0448949
240,240,2950,0.001162192,5953,0.001517268,-3003,-0.000355075,-0.0355075
241,241,2887,0.001137373,7445,0.00189754,-4558,-0.000760168,-0.0760168
242,242,7344,0.002893268,11155,0.002843125,-3811,5.01E-05,0.00501434
243,243,3126,0.00123153,9117,0.002323691,-5991,-0.001092161,-0.1092161
244,244,811,0.000319504,1780,0.000453677,-969,-0.000134172,-0.0134172
245,245,1139,0.000448724,4445,0.001132917,-3306,-0.000684193,-0.0684193
246,246,794,0.000312807,2102,0.000535746,-1308,-0.000222939,-0.0222939
247,247,6166,0.002429179,10540,0.002686377,-4374,-0.000257198,-0.0257198
248,248,4097,0.001614069,9167,0.002336434,-5070,-0.000722366,-0.0722366
249,249,8487,0.003343569,16020,0.004083089,-7533,-0.000739521,-0.0739521
250,250,4469,0.001760623,6641,0.001692621,-2172,6.80E-05,0.00680016
251,251,7161,0.002821173,14231,0.003627119,-7070,-0.000805946,-0.0805946
252,252,2219,0.000874205,3636,0.000926724,-1417,-5.25E-05,-0.00525185
253,253,2299,0.000905722,5862,0.001494074,-3563,-0.000588352,-0.0588352
254,254,3783,0.001490364,9372,0.002388684,-5589,-0.00089832,-0.089832
255,255,3062,0.001206316,8486,0.002162865,-5424,-0.000956548,-0.0956548
256,256,2269,0.000893903,7936,0.002022684,-5667,-0.001128781,-0.1128781
257,257,2270,0.000894297,6426,0.001637823,-4156,-0.000743526,-0.0743526
258,258,4468,0.001760229,9222,0.002350452,-4754,-0.000590223,-0.0590223
259,259,4219,0.001662132,16131,0.00411138,-11912,-0.002449248,-0.2449248
260,260,10761,0.004239442,15675,0.003995157,-4914,0.000244284,0.0244284
261,261,4630,0.001824051,8653,0.002205429,-4023,-0.000381378,-0.0381378
262,262,3423,0.001348537,7827,0.001994903,-4404,-0.000646365,-0.0646365
263,263,2332,0.000918723,4929,0.001256276,-2597,-0.000337553,-0.0337553
264,264,832,0.000327778,1888,0.000481203,-1056,-0.000153425,-0.0153425
265,265,1422,0.000560216,2585,0.000658851,-1163,-9.86E-05,-0.00986344
266,266,1309,0.000515698,3801,0.000968778,-2492,-0.00045308,-0.045308
267,267,2314,0.000911632,6863,0.001749204,-4549,-0.000837572,-0.0837572
268,268,9188,0.003619737,13875,0.003536383,-4687,8.34E-05,0.00833536
269,269,1623,0.000639403,3172,0.000808462,-1549,-0.000169059,-0.0169059
270,270,2092,0.000824172,4826,0.001230024,-2734,-0.000405853,-0.0405853
271,271,2682,0.00105661,9130,0.002327004,-6448,-0.001270394,-0.1270394
272,272,2453,0.000966393,7675,0.001956162,-5222,-0.000989769,-0.0989769
273,273,3348,0.00131899,5029,0.001281764,-1681,3.72E-05,0.00372262
274,274,1523,0.000600006,3331,0.000848987,-1808,-0.00024898,-0.024898
275,275,8012,0.003156436,15763,0.004017586,-7751,-0.000861151,-0.0861151
276,276,1480,0.000583066,1968,0.000501593,-488,8.15E-05,0.00814731
277,277,2704,0.001065277,5349,0.001363324,-2645,-0.000298046,-0.0298046
278,278,3873,0.001525821,9995,0.00254747,-6122,-0.00102165,-0.102165
279,279,3340,0.001315838,6500,0.001656684,-3160,-0.000340846,-0.0340846
280,280,1966,0.000774532,7795,0.001986747,-5829,-0.001212214,-0.1212214
281,281,3777,0.001488,6929,0.001766025,-3152,-0.000278025,-0.0278025
282,282,4503,0.001774018,9447,0.002407799,-4944,-0.000633781,-0.0633781
283,283,761,0.000299806,2249,0.000573213,-1488,-0.000273406,-0.0273406
284,284,1383,0.000544852,3386,0.000863005,-2003,-0.000318153,-0.0318153
285,285,1640,0.0006461,3740,0.000953231,-2100,-0.00030713,-0.030713
286,286,1110,0.0004373,2050,0.000522493,-940,-8.52E-05,-0.00851932
287,287,1959,0.000771775,6824,0.001739263,-4865,-0.000967489,-0.0967489
288,288,2539,0.001000273,8226,0.002096597,-5687,-0.001096324,-0.1096324
289,289,4369,0.001721227,8556,0.002180706,-4187,-0.000459479,-0.0459479
290,290,4511,0.001777169,9860,0.002513062,-5349,-0.000735893,-0.0735893
291,291,3141,0.001237439,10193,0.002597936,-7052,-0.001360496,-0.1360496
292,292,2714,0.001069217,5429,0.001383714,-2715,-0.000314496,-0.0314496
293,293,1580,0.000622462,2303,0.000586976,-723,3.55E-05,0.00354865
294,294,2008,0.000791079,6597,0.001681407,-4589,-0.000890328,-0.0890328
295,295,6718,0.002646647,10237,0.00260915,-3519,3.75E-05,0.0037497
296,296,1771,0.000697709,5208,0.001327386,-3437,-0.000629677,-0.0629677
297,297,1597,0.00062916,4709,0.001200204,-3112,-0.000571044,-0.0571044
298,298,4064,0.001601068,8500,0.002166433,-4436,-0.000565365,-0.0565365
299,299,1837,0.000723711,4568,0.001164267,-2731,-0.000440556,-0.0440556
300,300,4160,0.001638888,7887,0.002010195,-3727,-0.000371307,-0.0371307
301,301,2840,0.001118856,6023,0.001535109,-3183,-0.000416253,-0.0416253
302,302,2053,0.000808807,4029,0.001026889,-1976,-0.000218082,-0.0218082
303,303,3018,0.001188982,9032,0.002302026,-6014,-0.001113044,-0.1113044
304,304,3298,0.001299292,7979,0.002033643,-4681,-0.000734352,-0.0734352
305,305,4014,0.00158137,9305,0.002371607,-5291,-0.000790237,-0.0790237
306,306,2180,0.000858841,5233,0.001333758,-3053,-0.000474918,-0.0474918
307,307,2459,0.000968756,5107,0.001301644,-2648,-0.000332888,-0.0332888
308,308,2366,0.000932118,5653,0.001440805,-3287,-0.000508688,-0.0508688
309,309,2994,0.001179527,8354,0.002129221,-5360,-0.000949695,-0.0949695
310,310,3473,0.001368235,6892,0.001756595,-3419,-0.00038836,-0.038836
311,311,571,0.000224953,1574,0.000401172,-1003,-0.000176219,-0.0176219
312,312,3097,0.001220105,7023,0.001789983,-3926,-0.000569878,-0.0569878
313,313,1138,0.000448331,2290,0.000583663,-1152,-0.000135332,-0.0135332
314,314,1198,0.000471968,2759,0.000703199,-1561,-0.00023123,-0.023123
315,315,2196,0.000865144,5935,0.00151268,-3739,-0.000647536,-0.0647536
316,316,1671,0.000658313,6488,0.001653626,-4817,-0.000995313,-0.0995313
317,317,2795,0.001101128,6782,0.001728559,-3987,-0.000627431,-0.0627431
318,318,4010,0.001579794,9241,0.002355295,-5231,-0.000775501,-0.0775501
319,319,3014,0.001187406,5122,0.001305467,-2108,-0.000118061,-0.0118061
320,320,2009,0.000791473,4300,0.00109596,-2291,-0.000304488,-0.0304488
321,321,3101,0.001221681,6122,0.001560342,-3021,-0.000338661,-0.0338661
322,322,3484,0.001372569,6141,0.001565184,-2657,-0.000192615,-0.0192615
323,323,1248,0.000491666,3358,0.000855868,-2110,-0.000364202,-0.0364202
324,324,2610,0.001028245,6116,0.001558812,-3506,-0.000530567,-0.0530567
325,325,2466,0.000971514,5350,0.001363578,-2884,-0.000392064,-0.0392064
326,326,1654,0.000651616,3970,0.001011852,-2316,-0.000360236,-0.0360236
327,327,7028,0.002768776,16628,0.004238053,-9600,-0.001469277,-0.1469277
328,328,2163,0.000852143,5466,0.001393144,-3303,-0.000541001,-0.0541001
329,329,1318,0.000519244,3963,0.001010068,-2645,-0.000490824,-0.0490824
330,330,4523,0.001781897,8654,0.002205684,-4131,-0.000423787,-0.0423787
331,331,3958,0.001559308,9063,0.002309927,-5105,-0.00075062,-0.075062
332,332,2318,0.000913207,8450,0.002153689,-6132,-0.001240482,-0.1240482
333,333,2903,0.001143676,6666,0.001698993,-3763,-0.000555317,-0.0555317
334,334,3141,0.001237439,6103,0.001555499,-2962,-0.000318059,-0.0318059
335,335,6890,0.002714409,9606,0.002448324,-2716,0.000266085,0.0266085
336,336,3916,0.001542761,7853,0.002001529,-3937,-0.000458768,-0.0458768
337,337,2511,0.000989242,4795,0.001222123,-2284,-0.000232881,-0.0232881
338,338,2632,0.001036912,6038,0.001538932,-3406,-0.00050202,-0.050202
339,339,1207,0.000475514,3154,0.000803874,-1947,-0.00032836,-0.032836
340,340,4183,0.001647949,9324,0.00237645,-5141,-0.0007285,-0.07285
341,341,4200,0.001654647,10485,0.002672359,-6285,-0.001017712,-0.1017712
342,342,3081,0.001213802,6688,0.0017046,-3607,-0.000490799,-0.0490799
343,343,5514,0.002172315,10152,0.002587486,-4638,-0.000415171,-0.0415171
344,344,765,0.000301382,2060,0.000525041,-1295,-0.000223659,-0.0223659
345,345,3152,0.001241773,6120,0.001559832,-2968,-0.000318059,-0.0318059
346,346,2032,0.000800534,6129,0.001562126,-4097,-0.000761592,-0.0761592
347,347,2451,0.000965605,5999,0.001528992,-3548,-0.000563387,-0.0563387
348,348,2582,0.001017214,6146,0.001566459,-3564,-0.000549245,-0.0549245
349,349,3668,0.001445058,9911,0.002526061,-6243,-0.001081003,-0.1081003
350,350,1618,0.000637433,2572,0.000655537,-954,-1.81E-05,-0.00181042
351,351,2086,0.000821808,4192,0.001068434,-2106,-0.000246626,-0.0246626
352,352,2211,0.000871053,4837,0.001232828,-2626,-0.000361774,-0.0361774
353,353,1456,0.000573611,4855,0.001237416,-3399,-0.000663805,-0.0663805
354,354,1442,0.000568095,3822,0.00097413,-2380,-0.000406035,-0.0406035
355,355,3524,0.001388327,7657,0.001951574,-4133,-0.000563246,-0.0563246
356,356,3618,0.00142536,9157,0.002333886,-5539,-0.000908525,-0.0908525
357,357,2442,0.000962059,5738,0.00146247,-3296,-0.000500411,-0.0500411
358,358,3259,0.001283927,10738,0.002736842,-7479,-0.001452915,-0.1452915
359,359,2527,0.000995546,4925,0.001255257,-2398,-0.000259711,-0.0259711
360,360,3815,0.001502971,5746,0.001464509,-1931,3.85E-05,0.00384621
361,361,1058,0.000416813,4222,0.00107608,-3164,-0.000659267,-0.0659267
362,362,405,0.000159555,1879,0.000478909,-1474,-0.000319354,-0.0319354
363,363,792,0.000312019,1729,0.000440678,-937,-0.000128659,-0.0128659
364,364,1697,0.000668556,4363,0.001112017,-2666,-0.000443461,-0.0443461
365,365,559,0.000220226,2145,0.000546706,-1586,-0.00032648,-0.032648
366,366,2810,0.001107038,5276,0.001344718,-2466,-0.00023768,-0.023768
367,367,6048,0.002382691,11491,0.002928763,-5443,-0.000546071,-0.0546071
368,368,2760,0.001087339,8759,0.002232446,-5999,-0.001145106,-0.1145106
369,369,3047,0.001200407,6239,0.001590162,-3192,-0.000389755,-0.0389755
370,370,2793,0.00110034,5860,0.001493564,-3067,-0.000393224,-0.0393224
371,371,2381,0.000938027,6619,0.001687014,-4238,-0.000748987,-0.0748987
372,372,5357,0.002110463,10147,0.002586211,-4790,-0.000475749,-0.0475749
373,373,5026,0.001980061,9391,0.002393526,-4365,-0.000413465,-0.0413465
374,374,4722,0.001860296,4884,0.001244807,-162,0.000615489,0.0615489
375,375,1565,0.000616553,3969,0.001011597,-2404,-0.000395044,-0.0395044
376,376,3454,0.00136075,8736,0.002226583,-5282,-0.000865833,-0.0865833
377,377,1475,0.000581096,3728,0.000950172,-2253,-0.000369076,-0.0369076
378,378,1879,0.000740257,4990,0.001271824,-3111,-0.000531566,-0.0531566
379,379,2137,0.0008419,5119,0.001304702,-2982,-0.000462802,-0.0462802
380,380,1458,0.000574399,3264,0.00083191,-1806,-0.000257511,-0.0257511
381,381,1161,0.000457392,2983,0.000760291,-1822,-0.000302899,-0.0302899
382,382,1342,0.000528699,4334,0.001104626,-2992,-0.000575927,-0.0575927
383,383,2742,0.001080248,5258,0.00134013,-2516,-0.000259882,-0.0259882
384,384,4307,0.001696801,7642,0.001947751,-3335,-0.00025095,-0.025095
385,385,4514,0.001778351,6476,0.001650567,-1962,0.000127784,0.0127784
386,386,2391,0.000941967,2943,0.000750096,-552,0.000191871,0.0191871
387,387,1087,0.000428238,2402,0.000612208,-1315,-0.00018397,-0.018397
388,388,1742,0.000686284,3268,0.00083293,-1526,-0.000146645,-0.0146645
389,389,2672,0.001052671,5193,0.001323563,-2521,-0.000270893,-0.0270893
390,390,2521,0.000993182,5382,0.001371734,-2861,-0.000378552,-0.0378552
391,391,3668,0.001445058,6477,0.001650822,-2809,-0.000205764,-0.0205764
392,392,1799,0.00070874,3276,0.000834969,-1477,-0.000126228,-0.0126228
393,393,428,0.000168616,1169,0.000297948,-741,-0.000129332,-0.0129332
394,394,1250,0.000492454,3539,0.000902001,-2289,-0.000409546,-0.0409546
395,395,1346,0.000530275,3510,0.000894609,-2164,-0.000364334,-0.0364334
396,396,1788,0.000704407,3704,0.000944055,-1916,-0.000239648,-0.0239648
397,397,1463,0.000576369,2479,0.000631834,-1016,-5.55E-05,-0.00554652
398,398,1775,0.000699285,4563,0.001162992,-2788,-0.000463707,-0.0463707
399,399,905,0.000356537,3262,0.000831401,-2357,-0.000474864,-0.0474864
400,400,1362,0.000536578,3490,0.000889512,-2128,-0.000352934,-0.0352934
401,401,2031,0.00080014,5040,0.001284567,-3009,-0.000484427,-0.0484427
402,402,985,0.000388054,2318,0.000590799,-1333,-0.000202745,-0.0202745
403,403,3285,0.00129417,9412,0.002398879,-6127,-0.001104708,-0.1104708
404,404,876,0.000345112,2673,0.000681279,-1797,-0.000336167,-0.0336167
405,405,3102,0.001222075,6026,0.001535874,-2924,-0.000313799,-0.0313799
406,406,1304,0.000513728,3566,0.000908882,-2262,-0.000395154,-0.0395154
407,407,1645,0.00064807,3380,0.000861476,-1735,-0.000213406,-0.0213406
408,408,2308,0.000909268,4665,0.001188989,-2357,-0.000279722,-0.0279722
409,409,1884,0.000742227,3956,0.001008283,-2072,-0.000266056,-0.0266056
410,410,2498,0.000984121,6164,0.001571046,-3666,-0.000586925,-0.0586925
411,411,2218,0.000873811,5634,0.001435963,-3416,-0.000562152,-0.0562152
412,412,1255,0.000494424,3329,0.000848477,-2074,-0.000354053,-0.0354053
413,413,1999,0.000787533,4023,0.00102536,-2024,-0.000237827,-0.0237827
414,414,3950,0.001556156,5172,0.001318211,-1222,0.000237945,0.0237945
415,415,1761,0.00069377,3087,0.000786798,-1326,-9.30E-05,-0.00930277
416,416,1947,0.000767047,3627,0.00092443,-1680,-0.000157383,-0.0157383
417,417,1112,0.000438087,3210,0.000818147,-2098,-0.00038006,-0.038006
418,418,1937,0.000763107,4406,0.001122977,-2469,-0.00035987,-0.035987
419,419,744,0.000293109,1843,0.000469734,-1099,-0.000176625,-0.0176625
420,420,503,0.000198164,875,0.000223015,-372,-2.49E-05,-0.00248515
421,421,1226,0.000482999,3149,0.0008026,-1923,-0.0003196,-0.03196
422,422,6148,0.002422088,9678,0.002466675,-3530,-4.46E-05,-0.00445874
423,423,451,0.000177678,690,0.000175863,-239,1.81E-06,0.000181417
424,424,1695,0.000667768,3451,0.000879572,-1756,-0.000211804,-0.0211804
425,425,2048,0.000806837,5714,0.001456353,-3666,-0.000649515,-0.0649515
426,426,14681,0.005783779,10604,0.002702689,4077,0.00308109,0.308109
427,427,1741,0.000685891,2745,0.00069963,-1004,-1.37E-05,-0.00137399
428,428,336,0.000132372,829,0.000211291,-493,-7.89E-05,-0.00789192
429,429,3043,0.001198831,7968,0.00203084,-4925,-0.000832009,-0.0832009
430,430,2010,0.000791867,5035,0.001283293,-3025,-0.000491426,-0.0491426
431,431,1373,0.000540912,2697,0.000687396,-1324,-0.000146485,-0.0146485
432,432,1779,0.000700861,3651,0.000930547,-1872,-0.000229686,-0.0229686
433,433,1416,0.000557852,3657,0.000932076,-2241,-0.000374224,-0.0374224
434,434,1764,0.000694952,3792,0.000966484,-2028,-0.000271532,-0.0271532
435,435,1036,0.000408146,2330,0.000593858,-1294,-0.000185711,-0.0185711
436,436,1233,0.000485757,4328,0.001103097,-3095,-0.00061734,-0.061734
437,437,808,0.000318323,2319,0.000591054,-1511,-0.000272731,-0.0272731
438,438,752,0.000296261,2244,0.000571938,-1492,-0.000275678,-0.0275678
439,439,1371,0.000540124,4819,0.00122824,-3448,-0.000688116,-0.0688116
440,440,2831,0.001115311,7666,0.001953868,-4835,-0.000838557,-0.0838557
441,441,1520,0.000598825,1789,0.00045597,-269,0.000142854,0.0142854
442,442,1521,0.000599219,4022,0.001025105,-2501,-0.000425887,-0.0425887
443,443,1079,0.000425087,2647,0.000674653,-1568,-0.000249566,-0.0249566
444,444,618,0.000243469,1072,0.000273225,-454,-2.98E-05,-0.0029756
445,445,3185,0.001254774,6900,0.001758634,-3715,-0.00050386,-0.050386
446,446,499,0.000196588,649,0.000165414,-150,3.12E-05,0.00311743
447,447,1143,0.0004503,2276,0.000580094,-1133,-0.000129794,-0.0129794
448,448,1351,0.000532245,4863,0.001239455,-3512,-0.00070721,-0.070721
449,449,1156,0.000455422,2893,0.000737352,-1737,-0.00028193,-0.028193
450,450,1199,0.000472362,1074,0.000273735,125,0.000198627,0.0198627
451,451,1513,0.000596067,4099,0.00104473,-2586,-0.000448664,-0.0448664
452,452,1497,0.000589763,4843,0.001234357,-3346,-0.000644594,-0.0644594
453,453,1247,0.000491273,3078,0.000784504,-1831,-0.000293231,-0.0293231
454,454,2351,0.000926208,4788,0.001220339,-2437,-0.000294131,-0.0294131
455,455,1240,0.000488515,827,0.000210781,413,0.000277734,0.0277734
456,456,2329,0.000917541,4691,0.001195616,-2362,-0.000278075,-0.0278075
457,457,1282,0.000505061,3429,0.000873965,-2147,-0.000368903,-0.0368903
458,458,575,0.000226529,1604,0.000408819,-1029,-0.00018229,-0.018229
459,459,1858,0.000731984,4262,0.001086275,-2404,-0.000354291,-0.0354291
460,460,612,0.000241106,1135,0.000289283,-523,-4.82E-05,-0.00481768
461,461,2426,0.000955756,2139,0.000545177,287,0.000410579,0.0410579
462,462,2048,0.000806837,4704,0.00119893,-2656,-0.000392092,-0.0392092
463,463,776,0.000305716,828,0.000211036,-52,9.47E-05,0.00946796
464,464,2054,0.000809201,6229,0.001587613,-4175,-0.000778412,-0.0778412
465,465,530,0.000208801,1477,0.00037645,-947,-0.000167649,-0.0167649
466,466,849,0.000334475,1325,0.000337709,-476,-3.23E-06,-0.000323364
467,467,1953,0.000769411,4308,0.001097999,-2355,-0.000328588,-0.0328588
468,468,913,0.000359689,2353,0.00059972,-1440,-0.000240031,-0.0240031
469,469,139,5.48E-05,525,0.000133809,-386,-7.90E-05,-0.00790482
470,470,1284,0.000505849,3029,0.000772015,-1745,-0.000266166,-0.0266166
471,471,2143,0.000844264,3112,0.000793169,-969,5.11E-05,0.00510945
472,472,1870,0.000736712,5307,0.001352619,-3437,-0.000615907,-0.0615907
473,473,1550,0.000610643,1993,0.000507965,-443,0.000102679,0.0102679
474,474,1121,0.000441633,1144,0.000291576,-23,0.000150057,0.0150057
475,475,217,8.55E-05,207,5.28E-05,10,3.27E-05,0.00327311
476,476,2494,0.000982545,5970,0.001521601,-3476,-0.000539056,-0.0539056
477,477,1198,0.000471968,1252,0.000319103,-54,0.000152865,0.0152865
478,478,751,0.000295867,1759,0.000448324,-1008,-0.000152458,-0.0152458
479,479,1136,0.000447543,1293,0.000329553,-157,0.00011799,0.011799
480,480,966,0.000380569,1421,0.000362177,-455,1.84E-05,0.00183921
481,481,1919,0.000756016,3080,0.000785013,-1161,-2.90E-05,-0.00289974
482,482,2994,0.001179527,5953,0.001517268,-2959,-0.000337741,-0.0337741
483,483,1274,0.00050191,3385,0.00086275,-2111,-0.000360841,-0.0360841
484,484,1253,0.000493636,2960,0.000754428,-1707,-0.000260792,-0.0260792
485,485,667,0.000262774,1334,0.000340003,-667,-7.72E-05,-0.00772289
486,486,500,0.000196982,1247,0.000317828,-747,-0.000120847,-0.0120847
487,487,1457,0.000574005,5469,0.001393909,-4012,-0.000819904,-0.0819904
488,488,344,0.000135523,981,0.000250032,-637,-0.000114508,-0.0114508
489,489,1051,0.000414056,1637,0.00041723,-586,-3.17E-06,-0.000317384
490,490,748,0.000294685,815,0.000207723,-67,8.70E-05,0.0086962
491,491,1745,0.000687466,2462,0.000627501,-717,6.00E-05,0.00599654
492,492,1188,0.000468029,3100,0.000790111,-1912,-0.000322082,-0.0322082
493,493,332,0.000130796,503,0.000128202,-171,2.59E-06,0.000259403
494,494,560,0.00022062,822,0.000209507,-262,1.11E-05,0.00111128
495,495,1100,0.00043336,1640,0.000417994,-540,1.54E-05,0.00153657
496,496,996,0.000392388,2637,0.000672104,-1641,-0.000279716,-0.0279716
497,497,2347,0.000924632,6950,0.001771378,-4603,-0.000846745,-0.0846745
498,498,268,0.000105582,242,6.17E-05,26,4.39E-05,0.00439026
499,499,1617,0.000637039,3670,0.000935389,-2053,-0.00029835,-0.029835
500,500,1386,0.000546033,1326,0.000337964,60,0.00020807,0.020807
501,501,1079,0.000425087,2262,0.000576526,-1183,-0.000151439,-0.0151439
502,502,674,0.000265531,968,0.000246718,-294,1.88E-05,0.00188129
503,503,84,3.31E-05,381,9.71E-05,-297,-6.40E-05,-0.00640142
504,504,783,0.000308473,2405,0.000612973,-1622,-0.0003045,-0.03045
505,505,650,0.000256076,1213,0.000309163,-563,-5.31E-05,-0.00530864
506,506,544,0.000214316,1014,0.000258443,-470,-4.41E-05,-0.00441266
507,507,360,0.000141827,357,9.10E-05,3,5.08E-05,0.00508367
508,508,308,0.000121341,466,0.000118772,-158,2.57E-06,0.000256926
509,509,469,0.000184769,416,0.000106028,53,7.87E-05,0.00787411
510,510,336,0.000132372,492,0.000125398,-156,6.97E-06,0.000697351
511,511,890,0.000350628,644,0.000164139,246,0.000186488,0.0186488
512,512,697,0.000274593,774,0.000197273,-77,7.73E-05,0.00773197
513,513,578,0.000227711,742,0.000189117,-164,3.86E-05,0.00385941
514,514,364,0.000143403,908,0.000231426,-544,-8.80E-05,-0.00880233
515,515,317,0.000124886,953,0.000242895,-636,-0.000118009,-0.0118009
516,516,984,0.00038766,866,0.000220721,118,0.000166939,0.0166939
517,517,693,0.000273017,1248,0.000318083,-555,-4.51E-05,-0.00450666
518,518,1396,0.000549973,2237,0.000570154,-841,-2.02E-05,-0.00201811
519,519,1528,0.000601976,2391,0.000609405,-863,-7.43E-06,-0.000742859
520,520,540,0.00021274,652,0.000166178,-112,4.66E-05,0.00465622
521,521,1077,0.000424299,1367,0.000348413,-290,7.59E-05,0.00758853
522,522,1270,0.000500334,1108,0.000282401,162,0.000217933,0.0217933
523,523,633,0.000249379,1330,0.000338983,-697,-8.96E-05,-0.00896041
524,524,210,8.27E-05,222,5.66E-05,-12,2.62E-05,0.00261502
525,525,220,8.67E-05,563,0.000143494,-343,-5.68E-05,-0.00568224
526,526,1029,0.000405388,1308,0.000333376,-279,7.20E-05,0.00720127
527,527,55,2.17E-05,159,4.05E-05,-104,-1.89E-05,-0.0018857
528,528,1929,0.000759956,5192,0.001323308,-3263,-0.000563353,-0.0563353
529,529,52,2.05E-05,292,7.44E-05,-240,-5.39E-05,-0.00539372
530,530,375,0.000147736,864,0.000220212,-489,-7.25E-05,-0.00724752
531,531,587,0.000231257,440,0.000112145,147,0.000119112,0.0119112
532,532,354,0.000139463,678,0.000172805,-324,-3.33E-05,-0.00333418
533,533,304,0.000119765,392,9.99E-05,-88,1.99E-05,0.00198541
534,534,789,0.000310837,522,0.000133044,267,0.000177793,0.0177793
535,535,1754,0.000691012,1020,0.000259972,734,0.00043104,0.043104
536,536,553,0.000217862,545,0.000138907,8,7.90E-05,0.00789552
537,537,374,0.000147342,497,0.000126673,-123,2.07E-05,0.00206697
538,538,398,0.000156797,332,8.46E-05,66,7.22E-05,0.00721792
539,539,139,5.48E-05,251,6.40E-05,-112,-9.21E-06,-0.000921256
540,540,189,7.45E-05,541,0.000137887,-352,-6.34E-05,-0.0063428
541,541,86,3.39E-05,261,6.65E-05,-175,-3.26E-05,-0.00326414
542,542,626,0.000246621,595,0.00015165,31,9.50E-05,0.00949709
543,543,422,0.000166253,745,0.000189881,-323,-2.36E-05,-0.00236289
544,544,422,0.000166253,350,8.92E-05,72,7.70E-05,0.00770465
545,545,194,7.64E-05,386,9.84E-05,-192,-2.20E-05,-0.00219526
546,546,280,0.00011031,544,0.000138652,-264,-2.83E-05,-0.00283419
547,547,623,0.000245439,809,0.000206193,-186,3.92E-05,0.00392458
548,548,71,2.80E-05,98,2.50E-05,-27,2.99E-06,0.000299371
549,549,852,0.000335657,1987,0.000506436,-1135,-0.000170779,-0.0170779
550,550,484,0.000190678,470,0.000119791,14,7.09E-05,0.00708873
551,551,875,0.000344718,1025,0.000261246,-150,8.35E-05,0.00834718
552,552,449,0.00017689,1142,0.000291067,-693,-0.000114177,-0.0114177
553,553,300,0.000118189,474,0.000120811,-174,-2.62E-06,-0.000262144
554,554,271,0.000106764,495,0.000126163,-224,-1.94E-05,-0.00193987
555,555,373,0.000146948,255,6.50E-05,118,8.20E-05,0.00819554
556,556,120,4.73E-05,247,6.30E-05,-127,-1.57E-05,-0.00156784
557,557,1058,0.000416813,660,0.000168217,398,0.000248596,0.0248596
558,558,181,7.13E-05,190,4.84E-05,-9,2.29E-05,0.00228812
559,559,1220,0.000480636,706,0.000179941,514,0.000300694,0.0300694
560,560,296,0.000116613,331,8.44E-05,-35,3.22E-05,0.00322498
561,561,234,9.22E-05,561,0.000142985,-327,-5.08E-05,-0.00507971
562,562,36,1.42E-05,117,2.98E-05,-81,-1.56E-05,-0.00156376
563,563,38,1.50E-05,33,8.41E-06,5,6.56E-06,0.000655976
564,564,53,2.09E-05,117,2.98E-05,-64,-8.94E-06,-0.000894025
565,565,786,0.000309655,783,0.000199567,3,0.000110089,0.0110089
566,566,1041,0.000410116,3062,0.000780426,-2021,-0.00037031,-0.037031
567,567,567,0.000223377,985,0.000251051,-418,-2.77E-05,-0.0027674
568,568,217,8.55E-05,360,9.18E-05,-143,-6.26E-06,-0.000626472
569,569,598,0.00023559,1088,0.000277303,-490,-4.17E-05,-0.00417132
570,570,211,8.31E-05,410,0.000104499,-199,-2.14E-05,-0.00213722
571,571,2570,0.001012486,3559,0.000907098,-989,0.000105388,0.0105388
572,572,7744,0.003050854,16375,0.00417357,-8631,-0.001122716,-0.1122716
573,573,6416,0.00252767,11309,0.002882375,-4893,-0.000354705,-0.0354705
574,574,5392,0.002124251,12079,0.003078629,-6687,-0.000954377,-0.0954377
575,575,1563,0.000615765,3392,0.000864534,-1829,-0.000248769,-0.0248769
576,576,4146,0.001633373,9493,0.002419523,-5347,-0.000786151,-0.0786151
577,577,3282,0.001292988,8224,0.002096088,-4942,-0.000803099,-0.0803099
578,578,3330,0.001311899,7969,0.002031095,-4639,-0.000719196,-0.0719196
579,579,3782,0.00148997,7357,0.001875112,-3575,-0.000385141,-0.0385141
580,580,8910,0.003510215,12495,0.003184657,-3585,0.000325559,0.0325559
581,581,4727,0.001862266,8914,0.002271951,-4187,-0.000409685,-0.0409685
582,582,4204,0.001656223,8157,0.002079011,-3953,-0.000422788,-0.0422788
583,583,3174,0.00125044,5179,0.001319995,-2005,-6.96E-05,-0.00695546
584,584,1778,0.000700467,5925,0.001510131,-4147,-0.000809664,-0.0809664
585,585,1286,0.000506637,3357,0.000855614,-2071,-0.000348977,-0.0348977
586,586,1507,0.000593703,2493,0.000635402,-986,-4.17E-05,-0.0041699
587,587,3411,0.00134381,7749,0.001975022,-4338,-0.000631213,-0.0631213
588,588,1787,0.000704013,4315,0.001099783,-2528,-0.000395771,-0.0395771
589,589,2429,0.000956937,4407,0.001123232,-1978,-0.000166294,-0.0166294
590,590,599,0.000235984,498,0.000126927,101,0.000109057,0.0109057
591,591,3060,0.001205528,5770,0.001470626,-2710,-0.000265097,-0.0265097
592,592,2550,0.001004607,3835,0.000977444,-1285,2.72E-05,0.00271634
593,593,109,4.29E-05,271,6.91E-05,-162,-2.61E-05,-0.0026129
594,594,1084,0.000427056,2535,0.000646107,-1451,-0.00021905,-0.021905
595,595,1831,0.000721347,5008,0.001276411,-3177,-0.000555064,-0.0555064
596,596,1304,0.000513728,1746,0.000445011,-442,6.87E-05,0.00687176
597,597,431,0.000169798,1488,0.000379253,-1057,-0.000209455,-0.0209455
598,598,1223,0.000481817,1874,0.000477635,-651,4.18E-06,0.000418264
599,599,635,0.000250167,1050,0.000267618,-415,-1.75E-05,-0.00174514
600,600,1103,0.000434542,3167,0.000807187,-2064,-0.000372646,-0.0372646
601,601,311,0.000122523,434,0.000110616,-123,1.19E-05,0.00119071
602,602,393,0.000154828,940,0.000239582,-547,-8.48E-05,-0.00847543
603,603,303,0.000119371,665,0.000169492,-362,-5.01E-05,-0.00501206
604,604,848,0.000334081,2823,0.000719511,-1975,-0.00038543,-0.038543
605,605,432,0.000170192,792,0.000201861,-360,-3.17E-05,-0.00316683
606,606,324,0.000127644,385,9.81E-05,-61,2.95E-05,0.00295175
